4 4 4 4 4 4 4 4 4 4 4 4 4 4 4 4
4 3 1 3 3 1 2 3 3 3 3 3 3 3 3 4
4 3 4 4 3 4 4 4 4 4 4 3 4 4 3 4
4 3 3 3 3 3 3 3 3 3 4 3 4 3 3 4
4 2 4 3 4 3 4 2 3 3 1 3 4 2 0 4
4 4 4 3 4 3 4 4 4 3 4 3 4 4 4 4
5 3 3 3 4 3 2 0 4 3 4 3 3 1 3 4
4 4 4 3 4 1 4 4 4 3 4 3 4 4 3 3
4 3 4 3 4 3 4 3 3 3 4 3 3 3 3 4
4 3 3 3 4 3 4 4 4 4 4 4 3 3 3 4
4 0 2 3 3 3 3 3 3 3 3 3 3 0 2 4
4 4 4 4 4 4 4 4 4 4 4 4 4 4 4 4