
9 9 9 9 9 9 9 9 9 9 9 9 9 9 9 9 9 9 9 9 9 9 9 9 9 9 9 9 9 9 9 9 9 9 9 9 9 9 9 9
8 8 15 15 15 15 15 15 15 15 15 15 8 8 8 8 8 8 8 8 8 8 8 8 8 8 8 8 8 8 8 8 8 8 8 8 8 8 8 10
8 8 15 15 15 15 15 15 15 15 15 15 14 12 12 12 12 12 12 12 12 12 12 12 12 11 10 8 16 12 12 12 12 15 6 10 11 14 8 10
15 8 11 11 11 11 11 11 15 15 15 15 14 11 7 11 16 12 17 13 13 17 13 8 8 11 10 17 17 17 17 17 17 15 6 10 11 14 8 10
15 8 9 9 9 9 9 9 15 15 15 15 14 14 14 14 14 14 14 14 14 14 14 14 14 11 10 8 16 8 8 8 8 15 6 10 12 14 8 10
15 8 12 8 8 8 13 10 6 11 6 6 14 11 11 11 16 11 11 11 16 11 11 12 12 11 10 8 8 8 8 7 8 15 6 10 11 14 8 10
15 8 13 8 7 8 13 14 14 14 14 14 14 12 12 12 12 12 12 12 12 12 12 12 12 11 10 6 6 6 6 14 17 15 16 10 16 14 16 10
15 8 13 8 8 8 13 10 16 8 8 13 14 15 15 15 15 15 15 15 15 15 15 15 15 11 10 6 6 6 6 14 17 15 16 10 16 14 16 10
15 8 6 6 6 6 6 10 8 8 8 13 14 14 14 14 14 14 14 14 14 14 14 14 15 11 10 8 8 8 8 14 14 14 14 14 14 14 14 12
15 8 9 9 9 9 9 10 13 13 13 13 14 9 9 9 9 9 9 14 11 11 11 14 15 11 10 8 8 8 8 14 15 15 15 10 6 14 8 10
15 8 13 13 14 6 17 17 11 11 11 16 14 8 8 8 8 8 8 14 8 8 8 14 15 11 10 8 11 11 11 14 15 15 15 10 6 14 8 10
15 8 13 13 14 14 14 14 14 14 14 14 14 17 17 17 17 17 17 14 8 12 12 14 15 11 10 8 8 8 8 14 15 15 15 10 6 14 8 10
15 8 13 13 14 6 6 6 6 6 6 6 14 8 8 8 8 8 8 14 8 12 12 14 14 14 14 14 14 14 14 14 14 14 14 10 6 14 7 10
15 8 13 13 14 6 6 6 6 6 6 6 14 6 6 6 6 6 6 14 8 12 12 14 11 11 10 8 16 7 11 14 15 15 15 10 6 14 8 10
15 8 13 16 14 6 6 6 11 11 11 11 14 8 8 8 8 8 8 14 8 12 12 14 11 11 10 8 16 7 11 14 15 15 15 10 11 14 8 10
14 14 14 14 14 14 14 14 14 14 14 14 14 14 14 14 14 14 14 14 8 12 16 14 11 11 10 8 8 8 11 14 15 15 15 10 6 14 7 10
6 8 12 12 14 8 8 8 8 8 8 8 14 12 12 12 12 12 12 12 8 12 12 14 11 11 10 8 8 8 11 14 15 15 15 10 6 14 8 10
6 8 11 11 14 11 11 11 11 11 16 8 14 8 8 8 8 8 8 8 8 8 8 14 11 11 10 8 8 8 8 14 15 15 15 10 11 14 8 10
6 8 12 12 14 8 8 8 8 8 8 8 14 11 11 15 15 11 11 15 17 15 6 14 11 11 10 6 16 6 6 14 15 15 15 10 11 14 8 10
6 8 12 12 14 14 14 14 14 14 14 14 14 14 14 14 14 14 14 14 14 14 14 14 14 14 10 6 15 6 15 14 15 15 15 10 6 14 7 10
6 8 12 12 16 16 14 12 12 12 12 12 12 12 12 12 12 14 6 6 6 6 6 14 6 13 10 6 6 16 6 14 15 15 15 10 11 14 8 10
6 11 11 11 11 11 14 16 16 7 7 7 7 7 7 7 16 14 6 6 6 6 6 14 6 13 10 6 15 6 6 14 15 15 15 10 11 14 12 10
6 13 13 13 16 13 14 9 9 9 9 9 9 9 9 9 9 14 6 6 6 6 6 14 6 13 10 6 6 6 15 14 15 15 15 10 6 14 8 10
6 12 11 13 13 13 14 11 11 11 11 11 11 11 11 11 11 14 6 6 6 6 6 14 6 13 10 6 6 16 6 14 15 15 15 10 6 14 7 10
6 12 8 8 8 12 14 9 9 9 9 9 9 9 9 9 9 14 6 6 6 6 6 14 6 13 10 6 15 6 15 14 15 15 15 10 6 14 8 10
6 12 8 7 8 12 14 16 16 8 17 17 11 11 11 11 8 14 6 6 6 6 6 14 6 13 10 6 8 8 8 14 15 15 15 10 11 14 8 10
6 12 8 8 8 12 14 14 14 14 14 14 14 14 14 14 14 14 6 6 6 6 6 14 6 13 10 6 7 7 16 14 15 15 15 10 6 14 8 10
6 15 15 15 15 17 14 8 16 8 14 13 13 16 13 13 8 14 14 14 14 14 14 14 6 13 10 14 14 14 14 14 14 14 14 14 14 14 17 10
6 15 15 15 15 16 14 8 13 8 14 7 7 16 16 6 16 14 15 15 15 15 15 14 6 13 10 8 7 14 7 14 6 6 6 10 15 14 13 10
6 15 15 15 15 15 14 8 13 8 14 14 14 14 14 14 14 14 15 15 15 15 15 14 6 13 10 8 8 14 8 14 6 6 6 10 15 14 8 10
8 14 14 14 14 14 14 8 16 8 11 16 11 6 11 11 8 14 15 15 15 15 15 14 6 13 10 8 11 14 16 14 6 6 6 10 15 14 8 10
6 8 15 15 15 14 9 9 9 9 9 9 9 9 9 9 9 14 15 15 15 15 15 14 6 13 10 8 8 14 13 14 6 6 6 10 15 14 17 10
6 8 15 15 15 14 8 11 11 11 11 11 11 11 11 11 8 14 15 15 15 15 15 14 6 13 10 8 13 14 17 14 6 6 6 10 15 14 8 10
6 8 15 15 15 14 8 8 8 8 8 8 8 8 8 8 8 14 15 15 15 15 15 14 6 13 10 8 13 14 13 14 6 6 6 10 15 14 8 10
6 8 15 15 15 14 14 14 14 14 14 14 14 14 14 14 14 14 15 15 15 15 15 14 6 13 10 8 17 14 11 14 6 6 6 10 15 14 8 10
6 8 15 15 15 15 15 15 15 15 15 15 15 15 15 15 15 15 15 15 15 15 15 14 6 13 10 8 13 14 11 14 6 6 6 10 15 14 8 10
6 8 15 15 15 15 15 15 15 15 15 15 15 15 15 15 15 15 15 15 15 15 15 14 6 13 10 8 13 14 11 14 6 6 6 10 15 14 8 10
6 8 15 15 15 15 15 15 15 15 15 15 15 15 15 15 15 15 15 15 15 15 15 14 6 13 10 8 16 16 16 14 6 6 6 10 15 14 12 10
8 8 8 8 8 8 8 8 8 8 8 8 8 8 8 8 8 8 8 8 8 8 8 8 8 8 10 8 8 8 8 8 8 8 8 8 8 8 8 10
9 9 9 9 9 9 9 9 9 9 9 9 9 9 9 9 9 9 9 9 9 9 9 9 9 9 9 9 9 9 9 9 9 9 9 9 9 9 9 9




